a...........................................................................................................................#........................................a
a...........................................................................................................................#........................................a
a...........................................................................................................................#........................................a
a...............................................................................................#......#.x..................#........................................a
a......................................................................................#.......#....####..x............#....#.............................#..........a
a.......................x....x........................................................#.x.x.x.#...xx#......x...........#....#..###.n#####n................#..........a
a.......................#....#........""........##.#.#...............................#..######....###.......x.........#.....#..###"n.nnnn.#...#######.....#..........a
a.................xx....#....#.............xx...##.................xx...............#........................x.x.x.x.x#.......###.........#...#...........#......c...a
a.........##.x.x.n##....#....#.x.x.x.x.x.x.##...##.......#.......n###....#.x.x.x.x.#...x.x.x.x.x.x.x.x.x...##...#######.......##xxxxxxxxxx#...#...........#..........a
abbbbbbbbbbbbbbbbbbbbbbbbbbbbbbbbbbbbbbbbbbbbbbbbbbbbbbbbbbbbbbbbbbbbbbbbbbbbbbbbbbbbbbbbbbbbbbbbbbbbbbbbbbbbbbbbbbbbbbbbbbbbbbbbbbbbbbbbbbbbbbbbbbbbbbbbbbbbbbbbbbbba